%%%%%%%%%%%%%%%%%%%%
%o.  %        %    %
% %% % %%%%%% %% % %
% %              % %
% % %% %%  %% %% % %
%       G        % %
% % %% %%%%%% %% % %
% %              % %
% %% % %%%%%% % %% %
%    %   P    %    %
%%%%%%%%%%%%%%%%%%%%
