%%%%%%%%%%%%%%%%%%%%
%o   %        %    %
% %% % %%%%%% %% % %
% %     G        % %
% % %% %%  %% %% % %
%                % %
% % %% %%%%%% %% % %
% %              % %
% %% % %%%%%% % %% %
%    % PPPPP  %    %
%%%%%%%%%%%%%%%%%%%%