%%%%%
%Po.%
%...%
%..G%
%%%%%
