%%%%%
%Po.%
%o..%
%..G%
%%%%%
